11111111111111111111
11000000000000000011
10000000000000000001
12000000000000400031
10000000080000000005
10000000000000000001
10000000000000000001
10000000000000000001
11000000000000000011
11111111111111111111
/
11111111111111111111
10000011000000000001
12000010010000000001
10000004401000000001
10000000440010000001
10000000010000000031
10000011100000000005
10000000000000000001
10000000000000000001
11111111111111111111
/
11151111111111111111
11100000310000000011
11111100011110000001
12000000000000100001
11110000000111111111
10000000010400000001
10000000010000000001
10000001000000000001
11000000010000000011
11111111111111111111
/
11111111111111111111
11000000000000000011
10000000000000000001
10000000000000000001
10020001111110000003
10000010040000000005
10000010404010000001
10000001141110000001
11000000000010000011
11111111111111111111
/
11111111111111111111
10000000000000000001
10011100000001110001
10010100000001010001
10011100000001110001
10000000010000000001
10000000000000000001
10001111111111100001
10000000000000000001
11111111111111111111
